 , , ,9,1, , , ,6, 
4, ,6,8, ,5, , , , 
 ,2, ,4, , , ,7, , 
 ,4,1, , , , , , , 
2, ,5, , , ,4, ,3, 
 , , , , , ,2,5, , 
 ,1,7, , ,8, ,3, , 
 , , ,3, ,1,5, ,7, 
7, , , , ,6, , ,   
