8,5,7,9,1,2,3,4,6, 
4,3,6,8,7,5,9,1,2, 
1,2,9,4,6,3,8,7,5, 
3,4,1,5,2,9,7,6,8, 
2,6,5,1,8,7,4,9,3, 
9,7,8,6,3,4,2,5,1, 
5,1,2,7,4,8,6,3,9, 
6,8,4,3,9,1,5,2,7, 
7,9,3,2,5,6,1,8,4  
